


BBBBBBBBBBBBBBBBBBBBBBBBBBBB
BCCCCCCCCCCCCBBCCCCCCCCCCCCB
BCBBBBCBBBBBCBBCBBBBBCBBBBCB
BDBBBBCBBBBBCBBCBBBBBCBBBBDB
BCBBBBCBBBBBCBBCBBBBBCBBBBCB
BCCCCCCCCCCCCCCCCCCCCCCCCCCB
BCBBBBCBBCBBBBBBBBCBBCBBBBCB
BCBBBBCBBCBBBBBBBBCBBCBBBBCB
BCCCCCCBBCCCCBBCCCCBBCCCCCCB
BBBBBBCBBBBBEBBEBBBBBCBBBBBB
EEEEEBCBBBBBEBBEBBBBBCBEEEEE
EEEEEBCBBEEEEEEEEEEBBCBEEEEE
EEEEEBCBBEBBBBBBBBEBBCBEEEEE
BBBBBBCBBEBGGGGGGBEBBCBBBBBB
EEEEEECEEEBGGGGGGBEEECEEEEEE
BBBBBBCBBEBGGGGGGBEBBCBBBBBB
EEEEEBCBBEBBBBBBBBEBBCBEEEEE
EEEEEBCBBEEEEEEEEEEBBCBEEEEE
EEEEEBCBBEBBBBBBBBEBBCBEEEEE
BBBBBBCBBEBBBBBBBBEBBCBBBBBB
BCCCCCCCCCCCCBBCCCCCCCCCCCCB
BCBBBBCBBBBBCBBCBBBBBCBBBBCB
BCBBBBCBBBBBCBBCBBBBBCBBBBCB
BDCCBBCCCCCCCCCCCCCCCCBBCCDB
BBBCBBCBBCBBBBBBBBCBBCBBCBBB
BBBCBBCBBCBBBBBBBBCBBCBBCBBB
BCCCCCCBBCCCCBBCCCCBBCCCCCCB
BCBBBBBBBBBBCBBCBBBBBBBBBBCB
BCBBBBBBBBBBCBBCBBBBBBBBBBCB
BCCCCCCCCCCCCCCCCCCCCCCCCCCB
BBBBBBBBBBBBBBBBBBBBBBBBBBBB